WWWWWWWWWWWWWWWWWWWWW
WCW......S......S...W
W.WWW.WW......WW..WCW
W.WW.WW..W..WS.WWCWWW
W..L....WCW.WW...EWCW
W.W.....W.WWW.WWW.W.W
W.WWWWWWC..S....L.W.W
W.L.....WWWWWW.WWWWLW
W....L....XW........W
WWWWWWWWWWWWWWWWWWWLW
WP..S......S........W
WWWWWWWWWWWWWWWWWWWWW