WWWWWWWWWWW
WS...CW.L.W
W.WW.WW.W.W
W.W.....WSW
W.W.WWWWW.W
WSW..W..L.W
W.W.WWCW.WW
W.W.CWWW.SW
W.WWWWXWLWW
WS..PW...WW
WWWWWWWWWWW