WWWWWWWWWWWWWWWWWW
WP..S......SW....W
W.WWWWWWWWW.WXWW.W
W.W..S......LWW..W
W.WWWWW.WWWWWW..SW
W.WL...LW........W
WLW.WWWWWWWWWWWW.W
W.W...CWS.....L..W
W.WWWWWWWWWWWW...W
W.W...L..........W
W.W.WWWWWW.WW.WW.W
WS....LW...CW.CWCW
WWWWWWWWWWWWWWWWWW