WWWWWWWWWWWWWWWW
W......E.......W
W.WWWWWWWWWWW..W
W.W.......E...WW
W.W.WWWWWWWWWWXW
W.W......P..W..W
W.W.WW.WWWWWWW.W
W.W.WW..EWW..W.W
WEW.WWWWWW..WW.W
W.W....E.......W
W.WWWWWWWW.W..WW
W.W...E..W.W...W
W.WWW.WWW.W.WW.W
W.......E.W....W
WWWWWWWWWWWWWWWW