WWWWWWWWWWW
W....CW...W
W.WW.WW.W.W
W.W.....WEW
W.W.WWWWW.W
W.W..W....W
W.W.WWCW.WW
W.W.CWWW.EW
W.WWWWXW.WW
W...PW...WW
WWWWWWWWWWW