WWWWWWWWWWWWWWWWWWWW
W........E.........W
W.WWWWWW..........WW
W.WE....WWW.WW...EWW
W.W...........WWW.WW
W.WWWWWW...E..W...WW
W.E.....WWWWWW....WW
W....E....XWWW....WW
WWWWWWWWWWWW......WW
WP................WW
WWWWWWWWWWWWWWWWWWWW