WWWWWWWWWWWWWWW
W.....E.......W
W.WWWWWWWWWWW.W
W.WX....E.....W
W.WWWWWWWWW..WW
W.W.....E..WWWW
W.WWWWWWWW.W..W
WEW..........WW
W.WWWWWWWW.W..W
W...E......WWWW
W.WWWWWW.WWWWWW
W.....W......PW
WWWWWWWWWWWWWWW