WWWWWWWWWWWWWWWWWWWW
W.E..W....W...W....W
W.WW.W.WW.W.WWWW.WWW
W.WWXW.EW.W...W..E.W
W.WWWWWWWWW.W.WWWWWW
W.WWWEWEW..........W
W.....W.WWWWWWWWWWEW
W.WWWWW............W
W.......WWWWWWWWWWWW
W.WWWWWWWWWWWWWWWWWW
WE...WWWW.....WWWWWW
WWWW.WWWW.E...EWWWEW
WWWW..WWWW..WWWWWW.W
WWWWW....WW.WWWWWW.W
WWWWWWWW..W.WWWWW..W
WE.......W..W.....WW
W.WWWW.W.WWWWW.W..WW
W.....W.......W.W.PW
W.WWW.W.WWWWW.WWWWWW
W........W.........W
WWWWWWWWWWWWWWWWWWWW