WWWWWWWWWWWWWWW
W.....S.......W
W.WWWWWWWWWWW.W
W.WX....S.....W
W.WWWWWWWWWC.WW
W.WC.L..S..WWWW
W.WWWWWWWW.W.sW
WSW.L.....L..WW
W.WWWWWWWW.W.CW
W...S......WWWW
W.WWWWWW.WWWWWW
W.....WC.L...PW
WWWWWWWWWWWWWWW