WWWWWWWWWWWWWWWWWWWWW
WCW......E..........W
W.WWW.WW......WW..WCW
W.WW.WW..W..W..WWCWWW
W..E....WCW.WW...EWCW
W.W.....W.WWW.WWW.W.W
W.WWWWWWC..E......W.W
W.E.....WWWWWW.WWWW.W
W....E....XW........W
WWWWWWWWWWWWWWWWWWW.W
WP..................W
WWWWWWWWWWWWWWWWWWWWW