WWWWWWWWWWWWWWW
W.....S.......W
W.WWWWWWWWWWW.W
W.WX....S.....W
W.WWWWWWWWWC.WW
W.WC....S..WWWW
W.WWWWWWWW.W..W
WSW..........WW
W.WWWWWWWW.W.CW
W...S......WWWW
W.WWWWWW.WWWWWW
W.....WC.....PW
WWWWWWWWWWWWWWW