WWWWWWWWWWWWWWWWWWWW
W.E..W....W........W
W.W.WW.WW.W.WWWW.WWW
W.W.XW.EW.W...W..ECW
W.WWWWWWWWW.W.WWWWWW
W.W..EWEW..........W
W....CW.WWWWWWWWWWEW
W.WWWWW............W
W.......WWWW.WWWW.WW
W.WWWWW.WW.WWWWW..WW
WE...WW.W.....WWWWWW
W.WW.W..W.E...EWWE.W
W..W..WWWW..WW..WW.W
WW..W....WW..WW.WW.W
WWWWWWWW..W.WWWWW..W
WE.......W..W...W..W
W.WWWWWWWWWWW.....WW
W....CW.......W.W.PW
WWWWWWW.WWWWW.WWWWWW
WC.......W.........W
WWWWWWWWWWWWWWWWWWWW