WWWWWWWWWWWWWWWWWW
WP..........W....W
W.WWWWWWWWW.WXWW.W
W.W..E.......WW..W
W.WWWWW.WWWWWW...W
W.W....EW........W
W.W.WWWWWWWWWWWW.W
W.W....WE........W
W.WWWWWWWWWWWW...W
W.W...E..........W
W.W.WWWWWW.WW.WW.W
W.....EW....W..W.W
WWWWWWWWWWWWWWWWWW