WWWWWWWWWWWWWWW
W.....E.......W
W.WWWWWWWWWWW.W
W.WX....E.....W
W.WWWWWWWWWC.WW
W.WC....E..WWWW
W.WWWWWWWW.W..W
WEW..........WW
W.WWWWWWWW.W.CW
W...E......WWWW
W.WWWWWW.WWWWWW
W.....WC.....PW
WWWWWWWWWWWWWWW