WWWWWWWWWWWWWWWW
W......P......CW
WC.............W
W.L.......S....W
W....S.........W
W..............W
WC.....S...L...W
W.L........B...W
WWWWWWWWWWWXWWWW
WWWWWWWWWWWWWWWW