WWWWWWWWWWWWWWWW
W......P......CW
WC.............W
W.........E....W
W....E.........W
W..............W
WC.....E.......W
W..........B...W
WWWWWWWWWWWXWWWW
WWWWWWWWWWWWWWWW