WWWWWWWWWWWWWWWWWWWW
W.S..W....W....S...W
W.W.WW.WW.W.WWWW.WWW
W.W.XW.SW.W...W..SCW
W.WWWWWWWWW.W.WWWWWW
W.W..SWSW.....S....W
W....CW.WWWWWWWWWWLW
W.WWWWW...SS.......W
W..S....WWWW.WWWW.WW
W.WWWWW.WW.WWWWW..WW
WL...WW.W.....WWWWWW
W.WW.W..W.S...LWWL.W
W..W..WWWW..WW..WW.W
WW..W.S..WW..WW.WWSW
WWWWWWWW..W.WWWWW..W
WL.......W..W...W..W
W.WWWWWWWWWWW..S..WW
WS...CW...S...W.W.PW
WWWWW.W.WWWWW.WWWWWW
WC.......W.........W
WWWWWWWWWWWWWWWWWWWW