WWWWWWWWWWW
W.....W...W
W.WW.WW.W.W
W.W.....WEW
W.W.WWWWW.W
W.W..W....W
W.W.WW.W.WW
W.W..WWW.EW
W.WWWWXW.WW
W...PW...WW
WWWWWWWWWWW